Spinach – Bayam

Water spinach – Kangkung

Lettuce – Selada

Kale – Kale

Mustard greens – Sawi hijau

Cabbage – Kubis

Napa cabbage – Sawi putih

Bok choy – Pakcoy

Broccoli – Brokoli

Cauliflower – Kembang kol

Celery – Seledri

Swiss chard – Selada merah

Collard greens – Kubis collard

Arugula – Roket salad

Romaine lettuce – Selada romaine

Iceberg lettuce – Selada iceberg

Watercress – Selada air

Beet greens – Daun bit

Dandelion greens – Daun dandelion

Turnip greens – Daun lobak

Carrot – Wortel

Radish – Lobak

Beetroot – Bit

Turnip – Lobak putih

Daikon – Lobak daikon

Potato – Kentang

Sweet potato – Ubi jalar

Cassava – Singkong

Yam – Ubi

Taro – Talas

Onion – Bawang bombai

Shallot – Bawang merah

Garlic – Bawang putih

Leek – Bawang prei

Spring onion – Daun bawang

Scallion – Bawang kucai

Ginger – Jahe

Galangal – Lengkuas

Turmeric – Kunyit

Cucumber – Mentimun

Zucchini – Zukini

Eggplant – Terong

Tomato – Tomat

Pumpkin – Labu

Butternut squash – Labu butternut

Acorn squash – Labu acorn

Spaghetti squash – Labu spaghetti

Bitter melon – Pare

Chayote – Labu siam

Bell pepper – Paprika

Chili pepper – Cabai

Okra – Okra

Green bean – Buncis

Yardlong bean – Kacang panjang

Snow pea – Kacang kapri

Sugar snap pea – Kacang polong manis

Edamame – Kedelai hijau

Soybean – Kedelai

Lentil – Kacang lentil

Chickpea – Kacang arab

Mung bean – Kacang hijau

Kidney bean – Kacang merah

Black bean – Kacang hitam

Lima bean – Kacang lima

Peas – Kacang polong

Corn – Jagung

Bamboo shoot – Rebung

Lotus root – Akar teratai

Jicama – Bengkuang

Kohlrabi – Kohlrabi

Artichoke – Artichoke

Asparagus – Asparagus

Parsnip – Parsnip

Horseradish – Horseradish

Rutabaga – Rutabaga

Fennel – Adas

Celeriac – Seledri akar

Seaweed – Rumput laut

Nopales – Kaktus nopales

Radicchio – Radicchio

Endive – Endive

Purslane – Gendola

Sorrel – Sorrel

Mizuna – Mizuna

Tatsoi – Tatsoi

Malabar spinach – Genjer / Gendola

Amaranth greens – Daun bayam merah

Tinda – Labu tinda

Snake gourd – Labu ular

Bottle gourd – Labu botol

Ivy gourd – Kecipir

Winged bean – Kecipir

Cress – Selada air

Chives – Kucai

Parsley – Peterseli

Dill – Dill

Coriander / Cilantro – Ketumbar daun

Basil – Kemangi

Mint – Daun mint

Perilla – Daun perilla

dari 100 jenis sayur tersebut berikan link dari website kaggle.com untuk setiap jenis dataset gambarnya  jadi seperti ini misalnya untuk spinach link dataset gambar sendiri lalu dibawahnya lettuce link dataset gambar sendiri dan seterusnya. berikan dulu 5 jenis yang ada di daftar lalu nanti jika saya minta lanjutkan maka nanti anda lanjutkan dari list yanng saya kasih